111111111111111
100000000011001
1000000C0001C01
100E00000001001
10000000PC01001
111111111111111