1111111111111111111
1100000111100000011
1100C000000000C0011
1111111111111111111