111111111111111
100000000011001
1000000C0001001
1000E0000001001
10000000PC01001
111111111111111