11111111111111111111111
100000000000000000000C1
10101010101010101010101
10101010101010101010101
10101C10101010101010101
10101010101010101010101
10101010101C10101010101
10101010101010101010101
1C101010101010101010101
1P1010101010101010101E1
11111111111111111111111